R 170000 900000
WE  ./textures/wall3.xpm
NO  ./textures/telep.xpm
SO  ./textures/wall2.xpm
EA  ./textures/wall1.xpm
S   ./textures/scream.xpm
F   0,0,0          
C   0,0,255  

1111111111111111111111111111111
1000000000000000000000000000001
1000000000000000001111100000001
1000111111100000000020000000001
1000000011111100000000000000001
1000000000000000000000000000001
1000000000000000001111100000001
1000111111100000000000000000001
1000000011111100000020000000001
1000000000000000000000000000001
1000000000000000001111100000001
1000111111100000000000000000001
1000000011111100000N00000000001
1000000000000000000000000000001
1000000000000000001111100000001
1000111111100000000000000000001
1000000011111100000000000000001
1111111111111111111111111111111